

F        11,12,000

C  255,1,12

NO ./NO_texture.XPM

SO ./SO_texture.XPM

WE    ./WE_texture.XPM

EA      ./EA_texture.XPM


111111111111111
100000000000101
100101000000101
111110000010101
100000000010101
100000000000101
1000000S0000001
100000000000001
111111000111111
111111100011111
111111111000111
100000000000001
100000000000001
111111111111111