
  F        11,12,000

C  225,80,12

NO ./NO_texture.XPM

SO ./SO_texture.XPM
WE ./WE_texture.XPM

EA       ./EA_texture.XPM




         1111111111111111111111111
         1111111111111111111111111
         1111111111111111111111111
         10000000001100000000000001
111111111111011000001110000000000001
         100100000000000000000000111              
111111111011000001110000000000001111111      111111111
1000000000110000011101111111111111111111111111111111111
1111011111111011100000010001
11110111111111011101010010001
11000000110101011100000010001
11111111111111111111111111111
   11
      11111111     111111111111
111111111111111111111111111111111111
10000000000000001000000010001    1111  
10000000000000001101010010001    1011
111000001110101011111011110111  1111
11110111 1110101 10111N010001
11111111 1111111 111111111111