
NO ./images/wall1.xpm
SO ./images/wall2.xpm
WE    ./images/wall3.xpm
EA      ./images/wall4.xpm

F 38,70,83
C 244,162,97

111111111111111
100000000000101
100101000000101
100000000000101
1000000N0000101
1000000000000001
100000000000001
111111111111111